###################0#########
#1#0#0#0#0#0#0#0#0#*#0#0#0#0#
#00*000*00000000000*00000000#
#*#*#0#*#0#0#0#0#0#*#0#0#0#0#
#000000*000000000***00000000#
#0#*#*#0#*#0#0#0#0#0#0#0#0#0#
#00*00000***00000000000****0#
#0#*#0#0#0#*#0#*#*#0#0#0#0#0#
0***0000000*000000*0000000000
#0#0#0#0#0#*#0p0#0#*#0#0#0#0#
#00000000000**00000*00000000#
#0#0#0#0#0#0#0#*#*#*#0#*#*#*#
#0000*00000000000000000*0000#
#0#0#*#0#0#0#0#0#0#0#0#*#0#0#
#0****0000000000000****00000#
#0#0#0#0#0#0#*#0#0#0#0#0#*#*#
#000000000000*0000000000*000#
#0#0#0#0#0#0#*#0#0#0#0#*#0#0#
#000000000****000000000*0002#
###################0#########
